GID;Repite
102316;1
126078;1
126105;1
126107;1
147172;1
179986;1
180232;1
180329;1
182920;1
