GID;Repite
124966;1
146412;1
178963;1
178964;1
178965;1
180072;1
