GID;Repite
101872;1
101950;1
138819;1
138821;1
138822;1
138824;1
138826;1
138841;1
138852;1
138853;1
138897;1
139732;1
143674;1
176233;1
179877;1
179889;1
179960;1
179965;1
181323;1
