GID;Repite
117191;1
142082;1
142085;1
142086;1
142131;1
142151;1
146152;1
146692;1
164213;1
176347;1
181651;1
181888;1
182873;1
182880;1
