GID;Repite
116663;1
116711;1
116712;1
116714;1
125030;1
125032;1
130272;1
159872;1
173212;1
176524;1
179830;1
179841;1
179844;1
179903;1
179918;1
180605;1
182008;1
183090;1
