GID;Repite
102181;1
105691;1
118692;1
124338;1
124354;1
129651;1
129652;1
173033;1
173852;1
179775;1
179777;1
179778;1
181831;1
182133;1
182979;1
183008;1
